//MAP CONVERTED BY dmm2tgm.py THIS HEADER COMMENT PREVENTS RECONVERSION, DO NOT REMOVE
"a" = (
/turf/closed/wall/mineral/titanium,
/area/shuttle/arrival)
"b" = (
/obj/structure/chair/comfy/shuttle{
	dir = 8
	},
/obj/structure/window/reinforced/spawner/east,
/obj/effect/turf_decal/siding/white{
	dir = 8
	},
/obj/effect/turf_decal/siding/white{
	dir = 4
	},
/turf/open/floor/mineral/titanium/blue,
/area/shuttle/arrival)
"f" = (
/obj/structure/closet/emcloset,
/turf/open/floor/mineral/titanium/yellow,
/area/shuttle/arrival)
"g" = (
/obj/machinery/door/airlock/titanium{
	name = "Arrivals Shuttle Airlock"
	},
/turf/open/floor/plating,
/area/shuttle/arrival)
"h" = (
/turf/open/floor/mineral/titanium,
/area/shuttle/arrival)
"j" = (
/obj/structure/shuttle/engine/propulsion,
/turf/open/floor/plating/airless,
/area/shuttle/arrival)
"l" = (
/obj/structure/closet/firecloset/full,
/turf/open/floor/mineral/titanium/yellow,
/area/shuttle/arrival)
"n" = (
/obj/structure/chair/comfy/shuttle{
	dir = 4
	},
/obj/effect/turf_decal/siding/white{
	dir = 4
	},
/turf/open/floor/mineral/titanium/blue,
/area/shuttle/arrival)
"o" = (
/obj/structure/chair/comfy/shuttle{
	dir = 8
	},
/obj/structure/window/reinforced/spawner/east,
/obj/effect/turf_decal/siding/white/end{
	dir = 1
	},
/turf/open/floor/mineral/titanium/blue,
/area/shuttle/arrival)
"r" = (
/obj/effect/turf_decal/siding/white{
	dir = 8
	},
/turf/open/floor/mineral/titanium/blue,
/area/shuttle/arrival)
"s" = (
/turf/template_noop,
/area/template_noop)
"u" = (
/turf/open/floor/catwalk_floor/titanium,
/area/shuttle/arrival)
"v" = (
/obj/docking_port/mobile/arrivals{
	height = 9;
	port_direction = 4;
	width = 10
	},
/obj/machinery/door/airlock/titanium{
	name = "Arrivals Shuttle Airlock"
	},
/turf/open/floor/plating,
/area/shuttle/arrival)
"y" = (
/obj/structure/chair/comfy/shuttle{
	dir = 8
	},
/obj/structure/window/reinforced/spawner/east,
/obj/effect/turf_decal/siding/white/end,
/turf/open/floor/mineral/titanium/blue,
/area/shuttle/arrival)
"A" = (
/obj/structure/chair/comfy/shuttle{
	dir = 4
	},
/obj/structure/window/reinforced/spawner/west,
/obj/effect/turf_decal/siding/white{
	dir = 8
	},
/obj/effect/turf_decal/siding/white{
	dir = 4
	},
/turf/open/floor/mineral/titanium/blue,
/area/shuttle/arrival)
"D" = (
/obj/structure/chair/comfy/shuttle{
	dir = 4
	},
/obj/structure/window/reinforced/spawner/west,
/obj/effect/turf_decal/siding/white/end{
	dir = 1
	},
/turf/open/floor/mineral/titanium/blue,
/area/shuttle/arrival)
"F" = (
/obj/effect/turf_decal/siding/white{
	dir = 8
	},
/obj/machinery/light/directional/east,
/turf/open/floor/mineral/titanium/blue,
/area/shuttle/arrival)
"G" = (
/obj/effect/turf_decal/stripes/line,
/turf/open/floor/mineral/titanium/yellow,
/area/shuttle/arrival)
"I" = (
/obj/structure/window/reinforced{
	dir = 1
	},
/obj/structure/shuttle/engine/heater,
/turf/open/floor/plating/airless,
/area/shuttle/arrival)
"M" = (
/obj/effect/spawner/random/structure/table_or_rack,
/obj/item/storage/toolbox/emergency,
/turf/open/floor/mineral/titanium/yellow,
/area/shuttle/arrival)
"R" = (
/obj/structure/chair/comfy/shuttle{
	dir = 4
	},
/obj/structure/window/reinforced/spawner/west,
/obj/effect/turf_decal/siding/white/end,
/turf/open/floor/mineral/titanium/blue,
/area/shuttle/arrival)
"X" = (
/obj/effect/spawner/structure/window/reinforced/shuttle,
/turf/open/floor/plating,
/area/shuttle/arrival)
"Z" = (
/obj/structure/chair/comfy/shuttle{
	dir = 4
	},
/obj/effect/turf_decal/siding/white{
	dir = 4
	},
/obj/machinery/light/directional/west,
/turf/open/floor/mineral/titanium/blue,
/area/shuttle/arrival)

(1,1,1) = {"
s
s
a
a
X
X
X
a
a
a
"}
(2,1,1) = {"
s
a
a
Z
n
n
n
Z
I
j
"}
(3,1,1) = {"
a
a
G
h
h
h
h
h
I
j
"}
(4,1,1) = {"
X
f
G
h
o
b
y
h
a
a
"}
(5,1,1) = {"
X
l
G
h
u
u
u
h
X
s
"}
(6,1,1) = {"
X
M
G
h
D
A
R
h
a
a
"}
(7,1,1) = {"
a
a
G
h
h
h
h
h
I
j
"}
(8,1,1) = {"
s
a
a
F
r
r
r
F
I
j
"}
(9,1,1) = {"
s
s
a
a
g
a
v
a
a
a
"}
