//MAP CONVERTED BY dmm2tgm.py THIS HEADER COMMENT PREVENTS RECONVERSION, DO NOT REMOVE
"bj" = (
/obj/machinery/computer/security,
/turf/open/floor/mineral/titanium/yellow,
/area/shuttle/arrival)
"bI" = (
/turf/open/floor/wood,
/area/shuttle/arrival)
"cs" = (
/obj/structure/railing{
	dir = 1
	},
/obj/structure/water_source/puddle,
/obj/effect/turf_decal/siding/white{
	dir = 1
	},
/turf/open/floor/grass,
/area/shuttle/arrival)
"cu" = (
/obj/effect/spawner/random/clothing/wardrobe_closet_colored,
/obj/structure/railing{
	dir = 4
	},
/turf/open/floor/iron/corner{
	dir = 8
	},
/area/shuttle/arrival)
"cX" = (
/obj/effect/turf_decal/siding/thinplating/corner{
	dir = 1
	},
/obj/effect/turf_decal/siding/thinplating/corner{
	dir = 4
	},
/turf/open/floor/mineral/titanium,
/area/shuttle/arrival)
"eX" = (
/obj/structure/bed/pod,
/obj/item/bedsheet/dorms,
/turf/open/floor/wood,
/area/shuttle/arrival)
"fN" = (
/obj/machinery/light{
	dir = 1
	},
/turf/open/floor/mineral/titanium,
/area/shuttle/arrival)
"ha" = (
/obj/machinery/firealarm/directional/north,
/turf/open/floor/mineral/titanium,
/area/shuttle/arrival)
"hd" = (
/obj/effect/turf_decal/siding/thinplating{
	dir = 8
	},
/obj/effect/turf_decal/siding/thinplating{
	dir = 4
	},
/turf/open/floor/mineral/titanium,
/area/shuttle/arrival)
"hl" = (
/obj/machinery/door/airlock/titanium{
	name = "Autopilot Maintenance";
	req_access_txt = "12"
	},
/obj/effect/mapping_helpers/airlock/abandoned,
/obj/effect/turf_decal/siding/thinplating/corner,
/obj/effect/turf_decal/siding/thinplating/corner{
	dir = 8
	},
/turf/open/floor/mineral/titanium,
/area/shuttle/arrival)
"hC" = (
/obj/structure/window/spawner/east,
/obj/structure/chair/comfy/shuttle,
/turf/open/floor/glass/reinforced,
/area/shuttle/arrival)
"hN" = (
/obj/effect/decal/cleanable/dirt/dust,
/turf/open/floor/mineral/titanium/yellow,
/area/shuttle/arrival)
"ih" = (
/obj/structure/window/reinforced{
	dir = 1
	},
/obj/structure/shuttle/engine/heater,
/turf/open/floor/plating/airless,
/area/shuttle/arrival)
"ik" = (
/turf/open/floor/wood{
	icon_state = "wood-broken"
	},
/area/shuttle/arrival)
"iW" = (
/obj/structure/flora/ausbushes/grassybush,
/obj/structure/flora/ausbushes/lavendergrass,
/turf/open/floor/grass,
/area/shuttle/arrival)
"jq" = (
/obj/machinery/door/firedoor,
/turf/open/floor/mineral/titanium,
/area/shuttle/arrival)
"jv" = (
/obj/structure/railing{
	dir = 6
	},
/turf/open/floor/iron/corner{
	dir = 1
	},
/area/shuttle/arrival)
"jO" = (
/obj/structure/railing{
	dir = 1
	},
/obj/structure/flora/ausbushes/brflowers,
/obj/effect/turf_decal/siding/white{
	dir = 1
	},
/turf/open/floor/grass,
/area/shuttle/arrival)
"kD" = (
/obj/effect/spawner/structure/window/shuttle,
/turf/open/floor/plating,
/area/shuttle/arrival)
"kQ" = (
/obj/machinery/firealarm/directional/south,
/turf/open/floor/mineral/titanium,
/area/shuttle/arrival)
"ly" = (
/obj/structure/railing{
	dir = 1
	},
/obj/structure/flora/rock/pile,
/obj/effect/turf_decal/siding/white{
	dir = 1
	},
/obj/machinery/light{
	dir = 4
	},
/turf/open/floor/grass,
/area/shuttle/arrival)
"mc" = (
/obj/structure/railing{
	dir = 1
	},
/obj/effect/turf_decal/siding/white{
	dir = 1
	},
/turf/open/floor/grass,
/area/shuttle/arrival)
"mw" = (
/obj/structure/flora/ausbushes/lavendergrass,
/turf/open/floor/grass,
/area/shuttle/arrival)
"nu" = (
/obj/structure/chair/comfy/shuttle{
	dir = 1
	},
/obj/structure/sign/poster/official/no_erp{
	pixel_y = -32
	},
/turf/open/floor/wood,
/area/shuttle/arrival)
"nP" = (
/obj/machinery/light{
	dir = 1
	},
/turf/open/floor/wood{
	icon_state = "wood-broken"
	},
/area/shuttle/arrival)
"nX" = (
/obj/structure/railing{
	dir = 10
	},
/turf/open/floor/iron/corner{
	dir = 4
	},
/area/shuttle/arrival)
"oE" = (
/obj/effect/spawner/random/clothing/wardrobe_closet_colored,
/obj/structure/railing{
	dir = 8
	},
/turf/open/floor/iron/corner,
/area/shuttle/arrival)
"pC" = (
/turf/open/floor/mineral/titanium,
/area/shuttle/arrival)
"pS" = (
/turf/open/floor/iron/edge,
/area/shuttle/arrival)
"qv" = (
/obj/machinery/sheetifier{
	desc = "Hmm.. something seems wrong with this Autopilot machine. What could it be?";
	name = "Autopilot AI"
	},
/obj/effect/decal/cleanable/dirt/dust,
/turf/open/floor/mineral/titanium,
/area/shuttle/arrival)
"qV" = (
/obj/structure/shuttle/engine/propulsion,
/turf/open/floor/plating/airless,
/area/shuttle/arrival)
"re" = (
/obj/structure/flora/rock,
/turf/open/floor/grass,
/area/shuttle/arrival)
"rm" = (
/obj/machinery/door/airlock/titanium,
/turf/open/floor/plating,
/area/shuttle/arrival)
"rt" = (
/obj/structure/flora/ausbushes/sparsegrass,
/turf/open/floor/grass,
/area/shuttle/arrival)
"vb" = (
/obj/structure/chair/comfy/shuttle,
/turf/open/floor/glass/reinforced,
/area/shuttle/arrival)
"vH" = (
/obj/effect/decal/cleanable/dirt/dust,
/obj/item/stack/tile/mineral/titanium/yellow,
/turf/open/floor/plating,
/area/shuttle/arrival)
"wG" = (
/obj/structure/closet/radiation,
/obj/effect/decal/cleanable/dirt/dust,
/turf/open/floor/mineral/titanium/yellow,
/area/shuttle/arrival)
"xM" = (
/turf/open/floor/grass,
/area/shuttle/arrival)
"xT" = (
/obj/machinery/light,
/turf/open/floor/mineral/titanium,
/area/shuttle/arrival)
"xV" = (
/obj/structure/closet/toolcloset,
/turf/open/floor/mineral/titanium/yellow,
/area/shuttle/arrival)
"zS" = (
/obj/structure/bed/pod,
/obj/item/bedsheet/dorms,
/obj/effect/decal/cleanable/cobweb,
/turf/open/floor/wood,
/area/shuttle/arrival)
"Av" = (
/obj/structure/railing{
	dir = 1
	},
/obj/structure/flora/ausbushes/sparsegrass,
/obj/effect/turf_decal/siding/white{
	dir = 1
	},
/turf/open/floor/grass,
/area/shuttle/arrival)
"AY" = (
/obj/machinery/vending/clothing,
/obj/machinery/light{
	dir = 1
	},
/turf/open/floor/iron/edge{
	dir = 1
	},
/area/shuttle/arrival)
"Bk" = (
/obj/structure/closet/firecloset/full,
/turf/open/floor/mineral/titanium/yellow,
/area/shuttle/arrival)
"Bl" = (
/obj/effect/decal/cleanable/dirt/dust,
/obj/item/stack/tile/mineral/titanium/yellow,
/obj/machinery/light,
/turf/open/floor/plating,
/area/shuttle/arrival)
"Cv" = (
/obj/structure/flora/ausbushes/fullgrass,
/turf/open/floor/grass,
/area/shuttle/arrival)
"CV" = (
/obj/effect/decal/cleanable/dirt/dust,
/turf/open/floor/mineral/titanium,
/area/shuttle/arrival)
"CY" = (
/obj/structure/closet/emcloset,
/obj/effect/decal/cleanable/cobweb/cobweb2,
/turf/open/floor/mineral/titanium/yellow,
/area/shuttle/arrival)
"Ez" = (
/obj/structure/railing{
	dir = 1
	},
/obj/structure/flora/ausbushes/grassybush,
/obj/effect/turf_decal/siding/white{
	dir = 1
	},
/turf/open/floor/grass,
/area/shuttle/arrival)
"EC" = (
/obj/machinery/door/airlock/titanium,
/obj/docking_port/mobile/arrivals{
	dir = 4;
	dwidth = 11;
	height = 18;
	width = 30
	},
/turf/open/floor/plating,
/area/shuttle/arrival)
"FF" = (
/turf/closed/wall/mineral/titanium,
/area/shuttle/arrival)
"Ho" = (
/obj/structure/flora/grass/jungle,
/turf/open/floor/grass,
/area/shuttle/arrival)
"HT" = (
/obj/structure/window/spawner/west,
/obj/structure/chair/comfy/shuttle,
/turf/open/floor/glass/reinforced,
/area/shuttle/arrival)
"Ig" = (
/obj/effect/spawner/random/clothing/wardrobe_closet_colored,
/obj/machinery/light{
	dir = 1
	},
/turf/open/floor/iron/edge{
	dir = 1
	},
/area/shuttle/arrival)
"IU" = (
/turf/closed/wall/mineral/titanium/interior,
/area/shuttle/arrival)
"Kn" = (
/turf/template_noop,
/area/space)
"Kr" = (
/obj/structure/railing,
/turf/open/floor/iron/corner{
	dir = 4
	},
/area/shuttle/arrival)
"KM" = (
/obj/effect/turf_decal/siding/thinplating{
	dir = 1
	},
/turf/open/floor/mineral/titanium,
/area/shuttle/arrival)
"LD" = (
/obj/structure/railing,
/turf/open/floor/iron/corner{
	dir = 1
	},
/area/shuttle/arrival)
"LI" = (
/obj/machinery/light{
	dir = 1
	},
/turf/open/floor/wood,
/area/shuttle/arrival)
"MC" = (
/obj/structure/flora/ausbushes/ppflowers,
/turf/open/floor/grass,
/area/shuttle/arrival)
"ME" = (
/obj/effect/spawner/random/structure/table_fancy,
/turf/open/floor/wood,
/area/shuttle/arrival)
"MO" = (
/obj/structure/chair/comfy/shuttle{
	dir = 1
	},
/turf/open/floor/glass/reinforced,
/area/shuttle/arrival)
"NX" = (
/obj/effect/spawner/random/clothing/wardrobe_closet_colored,
/turf/open/floor/iron/edge{
	dir = 1
	},
/area/shuttle/arrival)
"OA" = (
/obj/structure/chair/comfy/shuttle{
	dir = 1
	},
/turf/open/floor/wood,
/area/shuttle/arrival)
"Rl" = (
/obj/machinery/vending/autodrobe/all_access,
/turf/open/floor/iron/corner{
	dir = 8
	},
/area/shuttle/arrival)
"Rn" = (
/obj/machinery/door/airlock/titanium{
	name = "Cabin II"
	},
/obj/effect/turf_decal/siding/wood{
	dir = 8
	},
/turf/open/floor/wood,
/area/shuttle/arrival)
"Ry" = (
/obj/machinery/door/airlock/titanium{
	name = "Cabin I"
	},
/obj/effect/turf_decal/siding/wood{
	dir = 4
	},
/turf/open/floor/wood,
/area/shuttle/arrival)
"SI" = (
/obj/structure/railing{
	dir = 1
	},
/obj/structure/flora/grass/jungle/b,
/obj/effect/turf_decal/siding/white{
	dir = 1
	},
/obj/machinery/light{
	dir = 8
	},
/turf/open/floor/grass,
/area/shuttle/arrival)
"SU" = (
/obj/structure/chair/comfy/shuttle{
	dir = 1
	},
/obj/structure/window/spawner/east,
/turf/open/floor/glass/reinforced,
/area/shuttle/arrival)
"Vk" = (
/turf/open/floor/mineral/titanium/yellow,
/area/shuttle/arrival)
"WG" = (
/obj/structure/rack,
/obj/item/storage/toolbox/mechanical,
/turf/open/floor/mineral/titanium/yellow,
/area/shuttle/arrival)
"WY" = (
/obj/structure/chair/comfy/shuttle{
	dir = 1
	},
/obj/structure/window/spawner/west,
/turf/open/floor/glass/reinforced,
/area/shuttle/arrival)
"XH" = (
/obj/effect/spawner/random/clothing/wardrobe_closet_colored,
/turf/open/floor/iron/corner,
/area/shuttle/arrival)
"Ym" = (
/obj/machinery/computer/aifixer,
/obj/effect/decal/cleanable/dirt/dust,
/turf/open/floor/mineral/titanium/yellow,
/area/shuttle/arrival)
"YB" = (
/obj/structure/rack,
/turf/open/floor/mineral/titanium/yellow,
/area/shuttle/arrival)
"Zf" = (
/obj/structure/chair/comfy/shuttle,
/turf/open/floor/wood,
/area/shuttle/arrival)

(1,1,1) = {"
Kn
Kn
Kn
Kn
FF
FF
FF
rm
FF
EC
FF
kD
kD
kD
FF
rm
FF
rm
FF
FF
FF
Kn
"}
(2,1,1) = {"
Kn
FF
FF
FF
FF
XH
Kr
KM
MO
pC
FF
Zf
ME
nu
FF
pC
vb
pC
SI
iW
FF
FF
"}
(3,1,1) = {"
FF
IU
xV
Bk
FF
Ig
pS
KM
MO
xT
FF
LI
bI
ik
FF
fN
vb
pC
mc
Cv
ih
qV
"}
(4,1,1) = {"
kD
WG
hN
Bl
FF
NX
pS
KM
MO
pC
FF
eX
bI
eX
FF
ha
vb
pC
jO
xM
ih
qV
"}
(5,1,1) = {"
kD
bj
vH
hN
FF
cu
jv
KM
SU
pC
FF
FF
Ry
FF
FF
pC
hC
pC
Av
re
ih
qV
"}
(6,1,1) = {"
kD
qv
CV
pC
hl
hd
hd
cX
pC
pC
jq
pC
pC
pC
jq
pC
pC
pC
mc
Ho
ih
qV
"}
(7,1,1) = {"
kD
Ym
hN
Vk
FF
oE
nX
KM
WY
pC
FF
FF
Rn
FF
FF
pC
HT
pC
Ez
MC
ih
qV
"}
(8,1,1) = {"
kD
YB
Vk
Bl
FF
NX
pS
KM
MO
kQ
FF
zS
bI
eX
FF
pC
vb
pC
mc
mw
ih
qV
"}
(9,1,1) = {"
FF
IU
CY
wG
FF
AY
pS
KM
MO
xT
FF
nP
bI
bI
FF
fN
vb
pC
cs
xM
ih
qV
"}
(10,1,1) = {"
Kn
FF
FF
FF
FF
Rl
LD
KM
MO
pC
FF
Zf
ME
OA
FF
pC
vb
pC
ly
rt
FF
FF
"}
(11,1,1) = {"
Kn
Kn
Kn
Kn
FF
FF
FF
kD
FF
kD
FF
kD
kD
kD
FF
kD
FF
kD
FF
kD
FF
Kn
"}
