//MAP CONVERTED BY dmm2tgm.py THIS HEADER COMMENT PREVENTS RECONVERSION, DO NOT REMOVE
"a" = (
/obj/structure/shuttle/engine/propulsion/burst,
/turf/closed/wall/mineral/titanium,
/area/shuttle/mining)
"b" = (
/obj/machinery/door/airlock/titanium{
	name = "Mining Pod Airlock"
	},
/obj/docking_port/mobile{
	dwidth = 1;
	height = 4;
	id = "mining";
	name = "mining shuttle";
	port_direction = 2;
	width = 3
	},
/turf/open/floor/mineral/titanium/blue,
/area/shuttle/mining)
"u" = (
/turf/closed/wall/mineral/titanium,
/area/shuttle/mining)
"N" = (
/obj/structure/chair/comfy/shuttle{
	dir = 1
	},
/obj/machinery/light/small/directional/west,
/turf/open/floor/mineral/titanium/blue,
/area/shuttle/mining)
"W" = (
/obj/machinery/computer/shuttle/mining,
/obj/machinery/status_display/evac/directional/west,
/obj/item/radio/intercom/directional/east,
/turf/open/floor/mineral/titanium/blue,
/area/shuttle/mining)
"Y" = (
/obj/effect/spawner/structure/window/reinforced/shuttle,
/turf/open/floor/plating,
/area/shuttle/mining)

(1,1,1) = {"
u
u
u
a
"}
(2,1,1) = {"
Y
W
N
b
"}
(3,1,1) = {"
u
u
u
a
"}
